00444400000000000000004400
00444400000000000000004400
44440000001111000000000044
44440000111111111100000044
44000001111111111111000022
44000001111111111111110000
22000011111111111111111000
00000011111111111111111000
00000111000000111111001000
00000100000000001111001000
33000100200020001110000000
33000100200020001110000000
00001100000000001110003333
00001100111100001110003333
00001111111111111111000000
00001111111111111111000000
00011111111111111111100000
00011111111111111111100000
00111111111111111111110000
00000011111111111100000000
00111100111111110011110044
00111111001111001111110044
44001111000000001111004444
44000000000111100000004444
22440000000155100000444422
22440000000155100000444422
2 5 3 10
