00000000000100104444000000
00000000000100104444000000
00100200100000000144100144
00100200100000000144100144
00100200100011000144100144
00100200100011000144100144
00110000110022001144001144
00110000110022001144001144
00000001220011001120004444
00000001000011000020004444
11111000004411440000011111
11111000004411440000011111
00000000014444441000000000
00000000014444441000000000
22111100114444441101111122
22111100004444440001111122
22222200000044000000222222
00000000110044001100000000
00110000110000001100000000
00110000110000001100000000
00111000001100110000011144
00111000000000000000011144
00001100000000000000444444
00000000000111100000444444
00000000000155100000004444
00001100000155100000114444
9 2 2 7
