00000000000000222200000000
00000000000000000000000000
00002222222200000000220000
00002200000000000000220000
00002200000044002222220000
00002200000044000022220000
00220000004422000000220000
00220000004422000000220000
00000000442222000000222200
00000000442222000000002200
00220044222222002200000000
00220044222222002200000000
00020022220000002222000000
00020022220000002222000000
20000000220022222200000200
20000000220022222200000200
00022200000022224400002200
00022200000022224400002200
00220000000022440000222200
00220000000022440000222200
00222222000044000022000000
00000022000044000022000000
00000000000000000022000022
00000000000111100000002222
00000000000155100000000000
22220000000155100000000000
10 4 0 6
